111111111111111111111111
100100000000000011000001
100100000000000011000001
1100N0000000000011000001
100100000000000011000001
100100000000000011000001
11111111111111111111111111111111           
