111111111111111111111111
100100111111111011000001
100100000000000000000001
100100000000000000000001
100100000000000000100001
1100001000N001101100000 
110000100000011011000001
100100011111110011000001
100100000000000011000001
100100000000000011000001
111111111111111111111111         
