111111111111111111111111
100100111111111011000001
100100111111111101100001
1100001000N0011011000001
110000100000011011000001
100100011111110011000001
100100000000000011000001
100100000000000011000001
111111111111111111111111         
