NO assets/wall_flat.xpm
SO assets/wall_flat.xpm
WE assets/wall_flat.xpm
EA assets/wall_flat.xpm

F 255, 204, 235
C 255,255,255

1111111111111111111111111
1000000000110000000000001
1011000001110000000000001
1001000000000000000000001
111111111011000001110000111111111
100000000011000001110111111111111
11110111111111011100000000001
111101111111110S1110101000001
11000000110101011100000000001
1000000000000000110000000001
10000000000000001101010000001
110000011101010111110111100111
11110111 1110101 101111010001
11111111 1111111 111111111111
