111111111111111111111111
100100000000000011000001
100100000000000000000001
110000000000000010000001
110000000000011010000001
1000000000N0000010000001
100000000000000010000001
100000000000000010000001
111111111111111111111111         
