NO assets/wall_flat.xpm
SO assets/wall_flat.xpm
WE assets/wall_flat.xpm
EA assets/wall_flat.xpm

F 255,204,235
C 255,255,255


1111111111111111111111111
1000000000110000000000001
1011000001110000000000001
1001000000000000000000001
1111111110110000011100001
1000000000110000011101111
1111011111111100110000001
111101111111110S011010101
1100000011010100110000001
1000000000000000110000001
1000000000000000110101001
1100000111010101111101111
11110111 1110101 10111101
11111111 1111111 11111111